111111
100101
102011
1101N1
111111
