111111
100101
102N01
110001
111111
