11111111111111111111111111111
10000000001100000000000000001
10110000111000000200000100001
12010020000000000000000010001
1N110000011100000000000010001
10020000001100000111011110001
11110111111111011100000010001
11110111111111011101010010001
11000000110101011100002010001
10002000000000001100000010001
10000000000000001101010010001
11000000110101011111011110001
11110111111101011111011110001
11111111111111111111111111111
