11111111
10000001
10000001
100E0001
11111111
