11111111
10000001
1S001001
10000001
10000001
11000001
10000001
11111111
