1111111
10000S1
1000001
1000001
1111111
