1111111
1000S01
1000001
1000001
1111111
